10600000000000000000000000000000
02000009999000000000000000000000
00600009999000000000000000000060
00000009999000000000000000000000
00000000000000000000000000000000